111111111111111
000000100010001
111110101010101
100010101000101
101110111010101
100010000010001
101011101010101
100000101010101
101011101010111
101000001000001
101111111111101
100010000000001
111011111010101
100000000010003
111111111111111
